10:10
0 0 0 17 0 0 0 0 0 33
0 0 16 37 0 0 0 36 128 35
0 0 0 34 32 0 0 0 0 0
16 16 16 0 0 0 0 0 0 0
17 17 17 17 0 0 0 0 0 0
0 96 0 0 0 0 0 52 0 0
0 0 0 0 0 0 0 0 0 0
0 0 0 0 0 0 0 0 0 0
0 0 0 0 0 0 0 0 0 0
81 82 83 84 85 0 0 0 0 64

