11:11
0 0 0 0 0 0 0 0 0 0 62
0 128 0 0 0 0 0 0 0 0 0
0 0 0 0 0 0 0 0 0 0 0
0 0 0 0 0 0 0 0 0 0 0
0 0 0 0 0 0 0 0 0 0 0
0 0 0 0 0 0 0 0 0 0 0
36 17 17 17 17 17 17 17 17 17 17
0 0 0 0 0 0 0 0 96 0 0
0 0 0 96 0 0 0 0 0 0 0
0 0 0 0 0 0 0 0 59 0 34
0 0 0 0 0 0 0 0 0 32 64