22:17
0 0 0 0 0 0 0 0 0 0 0 16 0 0 0 0 0 0 0 0 0 0
0 0 0 0 0 0 0 0 17 0 17 17 17 17 17 0 0 0 0 0 0 0
0 0 96 0 0 0 0 0 17 0 0 0 0 0 17 0 0 0 0 0 0 0
0 0 0 0 0 0 17 17 17 17 17 17 17 0 17 17 17 0 0 0 0 0
0 0 0 0 0 0 17 0 0 0 0 0 17 0 0 0 17 0 0 0 0 0
0 0 0 0 0 0 17 0 17 0 17 17 17 17 17 0 17 0 0 0 0 0
0 0 96 0 0 0 17 0 17 0 17 0 0 0 17 0 0 0 17 0 0 0
0 0 0 0 17 17 17 0 17 0 17 0 17 0 17 17 17 17 17 0 0 0 
0 0 0 0 17 0 17 0 17 0 17 17 17 0 17 0 0 0 17 0 0 0
0 0 0 0 17 0 17 0 17 0 17 0 0 0 17 17 17 0 17 0 0 0
0 0 17 17 17 0 17 0 17 0 17 0 0 0 17 0 17 0 17 0 0 0
96 0 17 0 0 0 0 0 17 0 17 0 17 0 0 0 17 0 17 17 17 0
0 0 17 0 17 17 17 17 17 0 17 0 17 17 17 17 17 0 17 0 17 0
18 0 17 0 0 0 17 0 0 0 17 0 0 0 0 0 0 0 17 0 0 0
17 17 17 0 17 17 17 0 17 17 17 0 17 17 17 17 17 17 17 0 17 17
17 128 17 0 17 0 0 0 17 0 17 0 0 0 0 0 17 0 0 0 0 17
17 0 0 0 0 17 0 0 0 0 0 0 0 0 0 0 0 0 0 0 0 17
