10:11
0 32 0 32 0 0 17 0 0 0
0 0 0 0 0 0 17 0 0 62
17 0 0 0 17 0 0 0 0 0
0 17 17 17 96 0 0 0 0 0
0 0 0 0 0 0 0 0 0 0
0 0 0 0 0 128 0 0 0 0
0 0 0 0 0 0 0 0 17 0
0 0 96 0 0 0 0 17 17 17
0 0 0 0 0 0 0 0 17 0
61 0 0 17 0 0 0 0 17 0
0 0 0 17 0 0 0 0 17 0