20:17
0 0 0 0 0 0 0 0 0 0 0 32 0 0 0 0 0 0 0 62
0 0 0 54 0 0 0 0 0 0 17 0 0 0 0 0 0 0 0 0
0 0 0 0 0 0 0 0 0 0 16 0 0 0 0 0 96 0 0 0
0 0 0 0 0 0 0 96 0 0 16 0 0 0 0 0 0 0 0 0
0 0 0 0 0 0 0 0 0 0 17 0 0 0 0 0 0 0 0 0
0 17 16 17 17 16 32 32 32 16 17 16 17 17 16 32 17 16 17 16
0 0 0 0 32 0 0 0 0 0 0 0 0 0 32 0 0 0 0 0
0 0 0 0 17 0 0 0 0 0 0 0 0 0 16 0 0 0 0 0
0 0 0 0 0 16 16 17 16 32 17 16 32 16 16 0 0 0 0 0
0 0 96 0 0 0 17 0 0 0 0 0 0 0 17 0 0 0 0 0
0 0 0 0 0 0 32 0 0 0 0 0 0 0 17 0 0 0 0 0
0 0 0 0 0 0 16 0 0 0 0 0 32 16 17 32 0 85 0 0
17 32 16 17 16 0 17 0 0 0 0 17 0 0 128 0 0 0 0 0
0 0 0 0 0 0 34 0 0 0 0 32 0 0 0 0 0 0 0 0
0 0 0 0 0 0 36 0 0 0 0 16 0 0 0 0 0 0 0 0
0 0 0 96 0 0 32 0 96 0 0 16 0 0 0 0 0 0 0 0
64 0 0 0 0 0 17 0 0 0 0 16 0 0 0 0 0 0 0 0

