10:11
17 17 17 17 128 17 17 17 17 17
17 0 0 0 0 17 0 0 17 0
17 0 0 17 0 0 17 0 0 17
17 0 17 0 17 0 17 0 17 0
17 0 17 17 0 37 17 0 17 17
0 0 0 17 0 0 17 0 17 0
17 0 0 17 0 0 0 0 0 64
0 0 17 0 17 0 17 0 0 17
17 0 0 0 17 17 17 17 17 0
32 32 32 32 32 32 32 32 32 17
0 0 0 0 0 0 0 0 0 58