12:12
128 0 0 0 0 0 0 0 0 0 0 0
17 17 17 0 17 0 17 17 17 17 0 0
0 0 0 0 17 37 17 0 0 17 0 0
36 0 96 0 17 32 17 0 0 17 0 0
34 0 0 0 17 0 17 0 0 17 0 0
0 0 0 0 17 17 17 0 0 17 0 0
0 0 0 0 0 0 0 0 0 17 0 0
0 16 32 16 0 0 0 0 0 17 0 0
0 16 16 16 0 0 0 0 0 17 0 0
0 0 0 0 0 0 0 0 64 17 0 0
35 17 17 17 17 17 17 17 17 17 0 0
0 0 0 0 0 56 0 0 0 0 0 0